XXXXXXXXXXXXXXXXXXXXXXXXXXXX
X.........XX....XX.........X
X.XXXXXXX.XX.XX.XX.XXXXXXX.X
XOXXXXXXX.XX.XX.XX.XXXXXXXOX
X.XX.........XX.........XX.X
X.XX.XX.XXXX.XX.XXXX.XX.XX.X
X....XX.XXXX.XX.XXXX.XX....X
XXXX.XX.XXXX.XX.XXXX.XX.XXXX
XXXX.XX..............XX.XXXX
 ....XXXX XXXXXXXX XXXX.... 
X.XX XXXX XXXXXXXX XXXX XX.X
X.XX         G          XX.X
X.XXXX XX XXX==XXX XX XXXX X
X.XXXX XX X      X XX XXXX X
X.     XX XG G G X XX      X
X.XX XXXX X      X XXXX XX X
X.XX XXXX XXXXXXXX XXXX XX X
X.XX                    XX X
X.XXXX XXXXX XX XXXXX XXXX X
X.XXXX XXXXX XX XXXXX XXXX X
X......XX    XX    XX      X
XXX XX XX XXXXXXXX XX      X
XXX XX XX XXXXXXXX XX      X
X   XX                     X
X XXXX                     X
X XXXX                     X
X                          X
X                          X
X                          X
X                          X
XXXXXXXXXXXXXXXXXXXXXXXXXXXX