level4	28	31
XXXXXXXXXXXXXXXXXXXXXXXXXXXX
X.........XX....XX.........X
X.XXXXXXX.XX.XX.XX.XXXXXXX.X
XOXXXXXXX.XX.XX.XX.XXXXXXXOX
X.XX.........XX.........XX.X
X.XX.XX.XXXX.XX.XXXX.XX.XX.X
X....XX.XXXX.XX.XXXX.XX....X
XXXX.XX.XXXX.XX.XXXX.XX.XXXX
XXXX.XX..............XX.XXXX
T....XXXX XXXXXXXX XXXX....T
X.XX XXXX XXXXXXXX XXXX XX.X
X.XX         B          XX.X
X.XXXX XX XXX==XXX XX XXXX.X
X.XXXX XX X      X XX XXXX.X
X.     XX XI P C X XX     .X
X.XX XXXX X      X XXXX XX.X
X.XX XXXX XXXXXXXX XXXX XX.X
X.XX         F          XX.X
X.XXXX XXXXX XX XXXXX XXXX.X
X.XXXX XXXXX XX XXXXX XXXX.X
X......XX....XX....XX......X
XXX.XX.XX.XXXXXXXX.XX.XX.XXX
XXX.XX.XX.XXXXXXXX.XX.XX.XXX
XO..XX.......1 .......XX..OX
X.XXXX.XXXXX.XX.XXXXX.XXXX.X
X.XXXX.XXXXX.XX.XXXXX.XXXX.X
X......XX....XX....XX......X
X.XXXX.XX.XXXXXXXX.XX.XXXX.X
X.XXXX.XX.XXXXXXXX.XX.XXXX.X
X......XX..........XX......X
XXXXXXXXXXXXXXXXXXXXXXXXXXXX