level3	28	31
XXXXXXXXXXXXXXXXXXXXXXXXXXXX
TTTTTT XX..........XX TTTTTT
XXXXXX XX.XXXXXXXX.XX XXXXXX
XXXXXX XX.XXXXXXXX.XX XXXXXX
XO...........XX...........OX
X.XXXXXXX XX.XX.XX.XXXXXXX.X
X.XXXXXXX XX.XX.XX.XXXXXXX.X
X.XX      XX.XX.XX......XX.X
X.XX XXXX XX....XX XXXX.XX.X
X.XX XXXX XXXXXXXX XXXX.XX.X
X......XX XXXXXXXX XX......X
XXXXXX.XX    B     XX.XXXXXX
XXXXXX.XX XXX==XXX XX.XXXXXX
X......XX X      X XX.     X
X.XXXX.XX XI P C X XX.XXXX X
X.XXXX.   X      X   .XXXX X
X...XX.XX XXXXXXXX XX.XX   X
XXX.XX.XX    F     XX.XX XXX
  X.XX.XXXX XXXX XXXX.XX X  
  X.XX.XXXX XXXX XXXX.XX X  
  X.........XXXX.........X  
  X.XXXXXXX.XXXX.XXXXXXX.X  
XXX.XXXXXXX.XXXX.XXXXXXX.XXX
TTT....XX... 1  ...XX....TTT
XXX.XX.XX.XXXXXXXX.XX.XX.XXX
XXX.XX.XX.XXXXXXXX.XX.XX.XXX
XO..XX.......XX.......XX..OX
X.XXXX.XXXXX.XX.XXXXX.XXXX.X
X.XXXX.XXXXX.XX.XXXXX.XXXX.X
X..........................X
XXXXXXXXXXXXXXXXXXXXXXXXXXXX