XXXXXXXXXX
X  .     X
X  . XX==X
X    X   X
X  X X G X
X XXFX   X
X  XXXXXXX
X    X O.X
X   PX  .X
X       .X
XXXXXXXXXX