level2	28	31
XXXXXXXXXXXXXXXXXXXXXXXXXXXX
X......XX..........XX......X
XOXXXX.XX.XXXXXXXX.XX.XXXXOX
X.XXXX.XX.XXXXXXXX.XX.XXXX.X
X..........................X
XXX.XX.XXXXX.XX.XXXXX.XX.XXX
  X.XX.XXXXX.XX.XXXXX.XX.X  
XXX.XX.XXXXX.XX.XXXXX.XX.XXX
TTT.XX.......XX.......XX.TTT
XXX.XXXXX XXXXXXXX XXXXX.XXX
  X.XXXXX XXXXXXXX XXXXX.X  
  X.         B          .X  
  X.XXXXX XXX==XXX XXXXX.X  
  X.XXXXX X      X XXXXX.X  
  X.XX    XI P C X    XX.X  
  X.XX XX X      X XX XX.X  
XXX.XX XX XXXXXXXX XX XX.XXX
TTT.   XX    F     XX   .TTT
XXX.XXXXXXXX XX XXXXXXXX.XXX
  X.XXXXXXXX XX XXXXXXXX.X  
  X.......   XX   .......X  
  X.XXXXX.XXXXXXXX.XXXXX.X  
XXX.XXXXX.XXXXXXXX.XXXXX.XXX
X............1 ............X
X.XXXX.XXXXX.XX.XXXXX.XXXX.X
X.XXXX.XXXXX.XX.XXXXX.XXXX.X
X.XXXX.XX....XX....XX.XXXX.X
XOXXXX.XX.XXXXXXXX.XX.XXXXOX
X.XXXX.XX.XXXXXXXX.XX.XXXX.X
X..........................X
XXXXXXXXXXXXXXXXXXXXXXXXXXXX