x    .   XXXXx
x    .   = G x
  .......=   X
  .XX.XX.XXXXX
  .XX.XX.     
.....O........
  .XX.XX.     
  .XX.XX. F   
  .......   xx
     .      xx
     . XXX    
     . XXX    