XXXXXXXXXXXXX XXXXXXXXXXXXXXXX
XO.........XX ..............OX
X.XXXXX.XX.XX XXXXX.XX.XXXXX.X
X.XXXXX.XX.XX XXXXX.XX.XXXXX.X
X.XX....XX..........XX....XX.X
X.XX.XXXXX.XXXXXXXX.XXXXX.XX.X
X.XX.XXXXX.XXXXXXXX.XXXXX.XX.X
X............................X
XXXXXXXXXXX.XXXXXX.XX.XXXXXXXX
XXXXXXXXXXX.XXXXXX.XX.XXXXXXXX
X.............XX...XX........X
X.XXXXXXXXXXX.XX.XXXXXXXXXXX.X
X.XXXXXXXXXXX....XXXXXXXXXXX.X
X.............XX.............X
XXXX.XXXXX.XX.XX.XXXXXXXXXXXXX 
XXXX.XXXXX.XX.XX.XXXXXXXXXXXXX
 ............F......   G      
X.XXXXX.XXXXX.XXXX.XXXX===XXXX
X.XXXXX.XXXXX.XXXX.X         X
X.............XXXX.X G G G G X
X.XXXXX.XXXXX.XXXX.X         X
X.XXXXX.XXXXX.XXXX.XXXX===XXXX
X............P...............X
X.XXXXXXXXXXX.XXXXXXXXXXXXXX.X
X.XXXXXXXXXXX.XXXXXXXXXXXXXX.X
X....XX....XX....XX....XX....X
X.XX.XX.XX.XX XX.XX.XX.XX.XX.X
 OXX....XX... XX....XX....XXO 
XXXXXXXXXXXXX XXXXXXXXXXXXXXXX